55555555555555555555
51111111111111111115
51000000011000000015
51011101011010121015
51000111000000000015
51010111011012101015
51000111001000000015
51111111101111111015
51021100001000111015
51011001011110112015
51000011211020211015
51110111112110114015
51010001110000011115
51010111111111011115
51000111102000000015
51011111111101101015
51000010110001100015
51011000000100311115
51111111111111111115
55555555555555555555